FlutterLogin(
        logo: "assets/logo_comif.png",
        loginAfterSignUp: false,
        userType: LoginUserType.email,
        messages: LoginMessages(
          flushbarTitleError: 'Erreur',
          loginButton: 'Se connecter',
          signupButton: 'S\'inscrire',
          goBackButton: 'Retour',
          confirmPasswordError: 'Les mots de passe ne correspondent pas',
          recoverPasswordDescription:
              'Un lien de récupération sera envoyé à votre adresse email',
          recoverPasswordIntro: 'Entrez votre email',
          recoverPasswordSuccess: 'Mot de passe récupéré avec succès',
        ),
        theme: LoginTheme(
          // change backgroundColor to lightTheme
          primaryColor: Theme.of(context).colorScheme.secondary,
          titleStyle: Theme.of(context).textTheme.displayLarge,
          textFieldStyle: Theme.of(context).textTheme.bodyMedium,
          bodyStyle: Theme.of(context).textTheme.bodyMedium,
          buttonTheme: const LoginButtonTheme(
            splashColor: Color.fromARGB(255, 0, 0, 0),
            backgroundColor: Color.fromARGB(255, 92, 1, 31),
            highlightColor: Color.fromARGB(255, 92, 1, 31),
            elevation: 9.0,
            highlightElevation: 6.0,
          ),
        ),
        title: 'Comif',
        onLogin: _authUser,
        savedEmail: email,
        hideForgotPasswordButton: true,
        onSubmitAnimationCompleted: () {
          Navigator.push(
              context,
              MaterialPageRoute(
                builder: (context) => TransactionScreen(
                    userData: userData, email: email, token: token),
              ));
        },
        onRecoverPassword: _recoverPassword,
      ),